READ FIRST: Life as you know it has virtually ended. People of the world have been affected by a deadly strain of bird flu. They have turned into the walking dead -zombies. You've yet to catch the virus, but they're catching up to you. You're next. You've left your home in California and now you're on the run. However, while you're on your journey you see a house. You need to go to the house for shelter and supplies.

Let Me In
An Interactive Fiction by Allison Smith
Release 1 / Serial number 141008 / Inform 7 build 6L02 (I6/v6.33 lib 6/12N) SD

Living room
You're in the living room right now of the old, abandoned house you found. You've been running for a while now. The zombies are catching up to you. While the zombies are slow, they're determined. You can't live like this anymore. You have to fight. Don't leave the house through the front entrance until you've gathered everything you need. You're already carrying a sword, just in case. The kitchen door is to the east. The front entrance door is to the west. The staircase is upward.  Keep in mind that the key that unlocks the front entrance is not something you would expect.

You can see a staircase, a kitchen_door, a front entrance door, a note, a vase, a table, an ax, a pair of steel-toed boots and a chest (closed) here.

>up
Playroom
The lavatory is to the east.

THERE'S A ZOMBIE UP HERE!!!! ATTAAAAAAAAAACK!

You can also see a staircase and a lavatory door here.

>attack zombie
You take the sword and stab the zombie and impale its head over and over again.

* * *

>take couch
That's fixed in place.

>take vase
That's fixed in place.

>x vase
delicate object.

>take table
That's fixed in place.

>take ax
Taken.

>x ax
A shiny, metal tool used for chopping.

>take boots
Taken.

>xboots
That's not a verb I recognise.

>x boots
A pair of shoes used to protect your feet.

>take chest
That's fixed in place.

>i
You are carrying:
  a pair of steel-toed boots
  an ax
  Sword

>x sword
sharp object meant for killing.

>e
(first opening the kitchen_door)

Kitchen
You've now entered the kitchen. There are a lot more useful supplies here. However, you need to hurry because the zombies are gaining on you. I can hear their relentless moans in the distance. This is not a time to be scared. You can push through and survive. The office door is south. The bedroom door is east.

You can see a kitchen_door, an office door, a bedroom_door, a pantry (closed), a round table, a knives and a fridge (closed) here.

>n
You can't go that way.

>e
(first opening the bedroom_door)

bedroom
You're finally in the bedroom. You've almost gathered all of the supplies that you need. The closet is to the north. The bedroom door is to the west. However, as you start searching the bedroom you realize there's three dead children mangled on the bed. Their intestines spilling out of their body. Their jaws torn from their face. You need to get out of here and quick!

You can see a bedroom_door, a closet door, a key and a dead children here.

>take key
Taken.

>x children
the dead bodies of the previous owner's children

>take children
That's fixed in place.

>w
Kitchen
You've now entered the kitchen. There are a lot more useful supplies here. However, you need to hurry because the zombies are gaining on you. I can hear their relentless moans in the distance. This is not a time to be scared. You can push through and survive. The office door is south. The bedroom door is east.

You can see a bedroom_door, a kitchen_door, an office door, a pantry (closed), a round table, a knives and a fridge (closed) here.

>w
Living room
You're in the living room right now of the old, abandoned house you found. You've been running for a while now. The zombies are catching up to you. While the zombies are slow, they're determined. You can't live like this anymore. You have to fight. Don't leave the house through the front entrance until you've gathered everything you need. You're already carrying a sword, just in case. The kitchen door is to the east. The front entrance door is to the west. The staircase is upward. Keep in mind that the key that unlocks the front entrance is not something you wouldn't expect.

You can see a kitchen_door, a staircase, a front entrance door, a note, a couch, a vase, a table and a chest (closed) here.

>go up
Playroom
THERE'S A ZOMBIE UP HERE!!!! ATTAAAAAAAAAACK!

You can also see a staircase and a lavatory door here.

>attack
What do you want to attack?

>zombie
You take the sword and stab the zombie and impale its head over and over again.

>e
(first opening the lavatory door)

Lavatory
You can see a lavatory door and a mirror cabinet (closed) here.

>w
Playroom
THERE'S A ZOMBIE UP HERE!!!! ATTAAAAAAAAAACK!

You can also see a lavatory door and a staircase here.

>take zombie
I don't suppose Undead would care for that.

>w
You can't go that way.

>e
Lavatory
You can see a lavatory door and a mirror cabinet (closed) here.

>open cabiney
You can't see any such thing.

>open cabinet
You open the mirror cabinet, revealing a razor.

>take razor
Taken.

>e
You can't go that way.

>w
Playroom
THERE'S A ZOMBIE UP HERE!!!! ATTAAAAAAAAAACK!

You can also see a lavatory door and a staircase here.

>go down
Living room
You're in the living room right now of the old, abandoned house you found. You've been running for a while now. The zombies are catching up to you. While the zombies are slow, they're determined. You can't live like this anymore. You have to fight. Don't leave the house through the front entrance until you've gathered everything you need. You're already carrying a sword, just in case. The kitchen door is to the east. The front entrance door is to the west. The staircase is upward. Keep in mind that the key that unlocks the front entrance is not something you wouldn't expect.

You can see a staircase, a kitchen_door, a front entrance door, a note, a couch, a vase, a table and a chest (closed) here.

>x chest
A metal box with something valueable in it.

>unlock chest with key
You unlock the chest.

>open chest
You open the chest, revealing a gun.

>take gun
Taken.

>unlock door
What do you want to unlock the front entrance door with?

>gun
You unlock the front entrance door.

    *** You run out of the house and you quickly realize you're surrounded. You try to fight the zombies off for as long as you can, but you quickly weaken. There's hundreds of them, but only one of you. As you're fighting a small pack of zombies one sneaks up behind you and rips your throat out. THE END ***

Would you like to RESTART, RESTORE a saved game, QUIT or UNDO the last command?

>u
Please give one of the answers above.

Would you like to RESTART, RESTORE a saved game, QUIT or UNDO the last command?

>undo
Living room
[Previous turn undone.]

>unlock door
What do you want to unlock the front entrance door with?

>razor
That doesn't seem to fit the lock.

>unlock door
What do you want to unlock the front entrance door with?

* * *

>x ax
A shiny, metal tool used for chopping.

* * *

>w
(first opening the front entrance door)
It seems to be locked.

>e
(first opening the kitchen_door)

Kitchen
You've now entered the kitchen. There are a lot more useful supplies here. However, you need to hurry because the zombies are gaining on you. I can hear their relentless moans in the distance. This is not a time to be scared. You can push through and survive.  The office door is south. The bedroom door is east. 

You can see a kitchen_door, an office door, a bedroom_door, a pantry (closed), a round table, a knives and a fridge (closed) here.

>e
(first opening the bedroom_door)

bedroom
You're finally in the bedroom. You've almost gathered all of the supplies that you need. The closet is to the north. The bedroom door is to the west . However, as you start searching the bedroom you realize there's three dead children mangled on the bed. Their intestines spilling out of their body. Their jaws torn from their face. You need to get out of here and quick!

You can see a bedroom_door, a closet door, a key and a dead children here.

* * *

>go up
Playroom
The lavatory is to the east.

THERE'S A ZOMBIE UP HERE!!!! ATTAAAAAAAAAACK!

You can also see a staircase and a lavatory door here.

>i
You are carrying:
  Sword

>x word
You can't see any such thing.

>x sword
sharp object meant for killing.

>kill zombies
You can't see any such thing.

>attack zombies
You can't see any such thing.

>attack zombie
You take the sword and stab the zombie and impale its head over and over again.

>go e
(first opening the lavatory door)

Lavatory
The lavatory is to the east.

You can see a lavatory door and a mirror cabinet (closed) here.

>x mirror
A medicine cabinet that holds something very important

* * *

>take all
That's not gonna happen, buddy,

>take
What do you want to take?

>all
That's not gonna happen, buddy,

>take couch
That's fixed in place.

* * *

>take vase
That's fixed in place.

>take table
That's fixed in place.

>i ax
I only understood you as far as wanting to take inventory.

>x ax
A shiny, metal tool used for chopping.

>take ax
Taken.

>take note
Gather all the supplies you need to fight the zombies and save yourself from death.

>take boots
Taken.

* * *

>take all
That's not gonna happen, buddy,

>take boots
Taken.

>take note
Gather all the supplies you need to fight the zombies and save yourself from death.

>take vase
That's fixed in place.

>take ax
Taken.

>take chest
That's fixed in place.

>e
(first opening the kitchen_door)

Kitchen
You've now entered the kitchen. There are a lot more useful supplies here. However, you need to hurry because the zombies are gaining on you. I can hear their relentless moans in the distance. This is not a time to be scared. You can push through and survive. The office door is south. The bedroom door is east.

You can see a kitchen_door, an office door, a bedroom_door, a pantry (closed), a round table, a knives and a fridge (closed) here.

>open pantry
You open the pantry, revealing water, beef jerky and nuts.

>take all
That's not gonna happen, buddy,

>take water
Taken.

>take beef jerky
Taken.

>take nuts
Taken.

>open fridge
A ZOMBIE HEAD! CLOSE THE FRIDGE BEFORE YOU BARF.

>take zombie head
Taken.

    *** The zombie head still had some bite to it! It bites you and you become a zombie. ***

Would you like to RESTART, RESTORE a saved game, QUIT or UNDO the last command?

>undo
Kitchen
[Previous turn undone.]

>take knives
Taken.

>w
Living room
You're in the living room right now of the old, abandoned house you found. You've been running for a while now. The zombies are catching up to you. While the zombies are slow, they're determined. You can't live like this anymore. You have to fight. Don't leave the house through the front entrance until you've gathered everything you need. You're already carrying a sword, just in case. The kitchen door is to the east. The front entrance door is to the west. The staircase is upward. Keep in mind that the key that unlocks the front enterance is not something you wouldn't expect.

You can see a kitchen_door, a staircase, a front entrance door, a note, a couch, a vase, a table and a chest (closed) here.

>w
(first opening the front entrance door)
It seems to be locked.

>up
Playroom
THERE'S A ZOMBIE UP HERE!!!! ATTAAAAAAAAAACK!

You can also see a staircase and a lavatory door here.

>open door
You open the lavatory door.

>go
You'll have to say which compass direction to go in.

>n
You can't go that way.

>w
You can't go that way.

* * *

>e
Lavatory
You can see a lavatory door and a mirror cabinet (closed) here.

>open mirror cabinet
You open the mirror cabinet, revealing a razor.

>take razor
Taken.

>w
Playroom
THERE'S A ZOMBIE UP HERE!!!! ATTAAAAAAAAAACK!

You can also see a lavatory door and a staircase here.

>w
You can't go that way.

>s
You can't go that way.

>e
Lavatory
You can see a lavatory door and a mirror cabinet (empty) here.

>w
Playroom
THERE'S A ZOMBIE UP HERE!!!! ATTAAAAAAAAAACK!

You can also see a lavatory door and a staircase here.

>n
You can't go that way.

>down
Living room
You're in the living room right now of the old, abandoned house you found. You've been running for a while now. The zombies are catching up to you. While the zombies are slow, they're determined. You can't live like this anymore. You have to fight. Don't leave the house through the front entrance until you've gathered everything you need. You're already carrying a sword, just in case. The kitchen door is to the east. The front entrance door is to the west. The staircase is upward. Keep in mind that the key that unlocks the front enterance is not something you wouldn't expect.

You can see a staircase, a kitchen_door, a front entrance door, a note, a couch, a vase, a table and a chest (closed) here.

>open chest
It seems to be locked.

>unlock chest with razor
That doesn't seem to fit the lock.

>oi
That's not a verb I recognise.

>i
You are carrying:
  a razor
  a knives
  nuts
  beef jerky
  water
  an ax
  a pair of steel-toed boots
  Sword

>e
Kitchen
You've now entered the kitchen. There are a lot more useful supplies here. However, you need to hurry because the zombies are gaining on you. I can hear their relentless moans in the distance. This is not a time to be scared. You can push through and survive. The office door is south. The bedroom door is east.

You can see a kitchen_door, an office door, a bedroom_door, a pantry (empty), a round table and a fridge (in which is Zombie head) here.

>e
(first opening the bedroom_door)

bedroom
You're finally in the bedroom. You've almost gathered all of the supplies that you need. The closet is to the north. The bedroom door is to the west. However, as you start searching the bedroom you realize there's three dead children mangled on the bed. Their intestines spilling out of their body. Their jaws torn from their face. You need to get out of here and quick!

You can see a bedroom_door, a closet door, a key and a dead children here.

* * *

>take key
Taken.

>n
(first opening the closet door)

closet
You can see a closet door here.

    *** You open the closet door and fall into a giant pit. In the giant pit, there are hoards of captive zombies. They quickly put an end to your life. ***

Would you like to RESTART, RESTORE a saved game, QUIT or UNDO the last command?

>undo
bedroom
[Previous turn undone.]

>w
Kitchen
You've now entered the kitchen. There are a lot more useful supplies here. However, you need to hurry because the zombies are gaining on you. I can hear their relentless moans in the distance. This is not a time to be scared. You can push through and survive. The office door is south. The bedroom door is east.

You can see a bedroom_door, a kitchen_door, an office door, a pantry (empty), a round table and a fridge (in which is Zombie head) here.

>s
(first opening the office door)

office
You can see an office door here.

    *** It's a booby trap! As you open the office door killer spears fly out and impale you. You die a terrible death. ***

Would you like to RESTART, RESTORE a saved game, QUIT or UNDO the last command?

>undo
Kitchen
[Previous turn undone.]

>n
You can't go that way.

>e
bedroom
You're finally in the bedroom. You've almost gathered all of the supplies that you need. The closet is to the north. The bedroom door is to the west. However, as you start searching the bedroom you realize there's three dead children mangled on the bed. Their intestines spilling out of their body. Their jaws torn from their face. You need to get out of here and quick!

You can see a bedroom_door, a closet door and a dead children here.

>undo
Kitchen
[Previous turn undone.]

>w
Living room
You're in the living room right now of the old, abandoned house you found. You've been running for a while now. The zombies are catching up to you. While the zombies are slow, they're determined. You can't live like this anymore. You have to fight. Don't leave the house through the front entrance until you've gathered everything you need. You're already carrying a sword, just in case. The kitchen door is to the east. The front entrance door is to the west. The staircase is upward. Keep in mind that the key that unlocks the front enterance is not something you wouldn't expect.

You can see a kitchen_door, a staircase, a front entrance door, a note, a couch, a vase, a table and a chest (closed) here.

>open chest
It seems to be locked.

>unlock chest with key
You unlock the chest.

* * *

>take gun
Taken.

>open front enterance
I only understood you as far as wanting to open the front entrance door.

>open front entrance
It seems to be locked.

>i
You are carrying:
  a gun
  a key
  a razor
  a knives
  nuts
  beef jerky
  water
  an ax
  a pair of steel-toed boots
  Sword

>unlock front entrance with beef jerky
That doesn't seem to fit the lock.

>unlock front entrance with ax
That doesn't seem to fit the lock.

>unlock front entrance with gun
That doesn't seem to fit the lock.

>unlock front entrance with key
That doesn't seem to fit the lock.

>unlock front entrance with razor
You unlock the front entrance door.

    *** You run out of the house and you quickly realize you're surrounded. You try to fight the zombies off for as long as you can, but you quickly weaken. There's hundreds of them, but only one of you. As you're fighting a small pack of zombies one sneaks up behind you and rips your throat out. THE END ***

Would you like to RESTART, RESTORE a saved game, QUIT or UNDO the last command?

>undo
Living room
[Previous turn undone.]

>x me
Your name is Lyndsee Palsi and you smell really bad.

>x gun
boom boom.

>x sword
sharp object meant for killing.

>x ax
A shiny, metal tool used for chopping.

* * *

>UP
Playroom
THERE'S A ZOMBIE UP HERE!!!! ATTAAAAAAAAAACK!

You can also see a staircase and a lavatory door here.

>ATTACK ZZOMBIE
You can't see any such thing.

>attack zombie
You take the sword and stab the zombie and impale its head over and over again.

* * *

>go east
(first opening the kitchen_door)

Kitchen
You've now entered the kitchen. There are a lot more useful supplies here. However, you need to hurry because the zombies are gaining on you. I can hear their relentless moans in the distance. This is not a time to be scared. You can push through and survive. The office door is south. The bedroom door is east.

You can see a kitchen_door, an office door, a bedroom_door, a pantry (closed), a round table, a knives and a fridge (closed) here.

>x pantry
food storage

>x round table
You see nothing special about the round table.

>e
(first opening the bedroom_door)

bedroom
You're finally in the bedroom. You've almost gathered all of the supplies that you need. The closet is to the north. The bedroom door is to the west. However, as you start searching the bedroom you realize there's three dead children mangled on the bed. Their intestines spilling out of their body. Their jaws torn from their face. You need to get out of here and quick!

You can see a bedroom_door, a closet door, a key and a dead children here.

>x dead children
the dead bodies of the previous owner's children

>go w
Kitchen
You've now entered the kitchen. There are a lot more useful supplies here. However, you need to hurry because the zombies are gaining on you. I can hear their relentless moans in the distance. This is not a time to be scared. You can push through and survive. The office door is south. The bedroom door is east.

You can see a bedroom_door, a kitchen_door, an office door, a pantry (closed), a round table, a knives and a fridge (closed) here.

>w
Living room
You're in the living room right now of the old, abandoned house you found. You've been running for a while now. The zombies are catching up to you. While the zombies are slow, they're determined. You can't live like this anymore. You have to fight. Don't leave the house through the front entrance until you've gathered everything you need. You're already carrying a sword, just in case. The kitchen door is to the east. The front entrance door is to the west. The staircase is upward. Keep in mind that the key that unlocks the front enterance is not something you would expect.

You can see a kitchen_door, a staircase, a front entrance door, a note, a couch, a vase, a table, an ax, a pair of steel-toed boots and a chest (closed) here.

>up
Playroom
THERE'S A ZOMBIE UP HERE!!!! ATTAAAAAAAAAACK!

You can also see a staircase and a lavatory door here.

>e
(first opening the lavatory door)

Lavatory
You can see a lavatory door and a mirror cabinet (closed) here.

>x mirror
A medicine cabinet that holds something very important

>open mirror
You open the mirror cabinet, revealing a razor.

>x razor
the key to your problems

>go w
Playroom
THERE'S A ZOMBIE UP HERE!!!! ATTAAAAAAAAAACK!

You can also see a lavatory door and a staircase here.

>w
You can't go that way.

>down
Living room
You're in the living room right now of the old, abandoned house you found. You've been running for a while now. The zombies are catching up to you. While the zombies are slow, they're determined. You can't live like this anymore. You have to fight. Don't leave the house through the front entrance until you've gathered everything you need. You're already carrying a sword, just in case. The kitchen door is to the east. The front entrance door is to the west. The staircase is upward. Keep in mind that the key that unlocks the front enterance is not something you would expect.

You can see a staircase, a kitchen_door, a front entrance door, a note, a couch, a vase, a table, an ax, a pair of steel-toed boots and a chest (closed) here.

>e
Kitchen
You've now entered the kitchen. There are a lot more useful supplies here. However, you need to hurry because the zombies are gaining on you. I can hear their relentless moans in the distance. This is not a time to be scared. You can push through and survive. The office door is south. The bedroom door is east.

You can see a kitchen_door, a bedroom_door, an office door, a pantry (closed), a round table, a knives and a fridge (closed) here.

>take fridge
That's fixed in place.

>take table
That's fixed in place.

* * *

>take ax
Taken.

>take boots
Taken.

>take chest
That's fixed in place.

* * *

>i
You are carrying:
  a pair of steel-toed boots
  an ax
  Sword

>n
You can't go that way.

>go up
Playroom
The lavatory is to the east.

THERE'S A ZOMBIE UP HERE!!!! ATTAAAAAAAAAACK!

You can also see a staircase and a lavatory door here.

>attack
What do you want to attack?

* * *

>zombie
You take the sword and stab the zombie and impale its head over and over again.

>attack zombie
The zombie is no longer a problem. Move on murderer.

>e
(first opening the lavatory door)

Lavatory
The lavatory is to the east.

You can see a lavatory door and a mirror cabinet (closed) here.

>open cabinet
You open the mirror cabinet, revealing a razor.

* * *

>take razor
Taken.

>w
Playroom
The lavatory is to the east.

THERE'S A ZOMBIE UP HERE!!!! ATTAAAAAAAAAACK!

You can also see a lavatory door and a staircase here.

>w
You can't go that way.

>go down
Living room
You're in the living room right now of the old, abandoned house you found. You've been running for a while now. The zombies are catching up to you. While the zombies are slow, they're determined. You can't live like this anymore. You have to fight. Don't leave the house through the front entrance until you've gathered everything you need. You're already carrying a sword, just in case. The kitchen door is to the east. The front entrance door is to the west. The staircase is upward.  Keep in mind that the key that unlocks the front entrance is not something you would expect.

You can see a staircase, a kitchen_door, a front entrance door, a note, a couch, a vase, a table and a chest (closed) here.

>w
(first opening the front entrance door)
It seems to be locked.

>n
You can't go that way.

>e
(first opening the kitchen_door)

Kitchen
You've now entered the kitchen. There are a lot more useful supplies here. However, you need to hurry because the zombies are gaining on you. I can hear their relentless moans in the distance. This is not a time to be scared. You can push through and survive.  The office door is south. The bedroom door is east. 

You can see a kitchen_door, an office door, a bedroom_door, a pantry (closed), a round table, a knives and a fridge (closed) here.

* * *

>e
(first opening the bedroom_door)

bedroom
You're finally in the bedroom. You've almost gathered all of the supplies that you need. The closet is to the north. The bedroom door is to the west . However, as you start searching the bedroom you realize there's three dead children mangled on the bed. Their intestines spilling out of their body. Their jaws torn from their face. You need to get out of here and quick!

You can see a bedroom_door, a closet door, a key and a dead children here.

>take key
Taken.

>w
Kitchen
You've now entered the kitchen. There are a lot more useful supplies here. However, you need to hurry because the zombies are gaining on you. I can hear their relentless moans in the distance. This is not a time to be scared. You can push through and survive.  The office door is south. The bedroom door is east. 

You can see a bedroom_door, a kitchen_door, an office door, a pantry (closed), a round table, a knives and a fridge (closed) here.

>e
bedroom
You're finally in the bedroom. You've almost gathered all of the supplies that you need. The closet is to the north. The bedroom door is to the west . However, as you start searching the bedroom you realize there's three dead children mangled on the bed. Their intestines spilling out of their body. Their jaws torn from their face. You need to get out of here and quick!

You can see a bedroom_door, a closet door and a dead children here.

>e
Kitchen
You've now entered the kitchen. There are a lot more useful supplies here. However, you need to hurry because the zombies are gaining on you. I can hear their relentless moans in the distance. This is not a time to be scared. You can push through and survive.  The office door is south. The bedroom door is east. 

You can see a bedroom_door, a kitchen_door, an office door, a pantry (closed), a round table, a knives and a fridge (closed) here.

>n
You can't go that way.

>s
(first opening the office door)

office
The lavatory is to the east.

You can see an office door here.

    *** It's a booby trap! As you open the office door killer spears fly out and impale you. You die a terrible death. ***

Would you like to RESTART, RESTORE a saved game, QUIT or UNDO the last command?

>undo
Kitchen
[Previous turn undone.]

>e
bedroom
You're finally in the bedroom. You've almost gathered all of the supplies that you need. The closet is to the north. The bedroom door is to the west . However, as you start searching the bedroom you realize there's three dead children mangled on the bed. Their intestines spilling out of their body. Their jaws torn from their face. You need to get out of here and quick!

You can see a bedroom_door, a closet door and a dead children here.

>w
Kitchen
You've now entered the kitchen. There are a lot more useful supplies here. However, you need to hurry because the zombies are gaining on you. I can hear their relentless moans in the distance. This is not a time to be scared. You can push through and survive.  The office door is south. The bedroom door is east. 

You can see a bedroom_door, a kitchen_door, an office door, a pantry (closed), a round table, a knives and a fridge (closed) here.

>n
You can't go that way.

>e
bedroom
You're finally in the bedroom. You've almost gathered all of the supplies that you need. The closet is to the north. The bedroom door is to the west . However, as you start searching the bedroom you realize there's three dead children mangled on the bed. Their intestines spilling out of their body. Their jaws torn from their face. You need to get out of here and quick!

You can see a bedroom_door, a closet door and a dead children here.

* * *

>w
Kitchen
You've now entered the kitchen. There are a lot more useful supplies here. However, you need to hurry because the zombies are gaining on you. I can hear their relentless moans in the distance. This is not a time to be scared. You can push through and survive.  The office door is south. The bedroom door is east. 

You can see a bedroom_door, a kitchen_door, an office door, a pantry (closed), a round table, a knives and a fridge (closed) here.

>g
Living room
You're in the living room right now of the old, abandoned house you found. You've been running for a while now. The zombies are catching up to you. While the zombies are slow, they're determined. You can't live like this anymore. You have to fight. Don't leave the house through the front entrance until you've gathered everything you need. You're already carrying a sword, just in case. The kitchen door is to the east. The front entrance door is to the west. The staircase is upward.  Keep in mind that the key that unlocks the front entrance is not something you would expect.

You can see a kitchen_door, a staircase, a front entrance door, a note, a couch, a vase, a table and a chest (closed) here.

>unlock chest
What do you want to unlock the chest with?

>key
You unlock the chest.

>open chest
You open the chest, revealing a gun.

* * *

>take gun
Taken.

>open door
It seems to be locked.

>gun
That's not a verb I recognise.

>unlock door
What do you want to unlock the front entrance door with?

* * *

>x me
Your name is Lyndsee Palsi and you smell really bad.

* * *

>x vase
delicate object.